------R-------
----U-U-U-----
---U--B--U----
---U--B--U----
---U--B--U----
---U--B--U----
----U-B-B-----
-----UUU------
------B-------
------U-------
------S-------