-----D-D------
----B-B-B-----
---U--I--A----
---*--*--*----
---*--*--*----
---V--*--V----
----A-V-U-----
-----VVV------
------I-------
------S-------