-----R-R------
----U-U-U-----
---U--B--U----
---U--B--U----
---U--B--U----
---U--B--U----
----U-U-U-----
-----UUU------
------U-------
------S-------