----F---F----
---B-----B---
--U-------U--
-A---------A-
A-U-------U-A
-A-A-----A-A-
--A-U---U-A--
---U-B-B-B---
----B---B----
-----U-U-----
------S------