----F---F----
---B-----B---
--*-------*--
-V---------V-
*-*-------*-*
-*-*-----*-*-
--*-*---*-*--
---*-*-*-*---
----V---V----
-----*-*-----
------S------